1111111111
1PC0000111
11C0000101
1110100111
10CX100111
10C100E111
10C0010011
1111111111