1111111111111111111
101100C000C00000001
100000P010000010101
1011000011100001001
1001000010000X01001
1001000111101001001
1001000010100001001
1001000111101111001
100100011110E001001
1001000111100001001
1111111111111111111